Общая БД книг для проета "Библиотека"



a-и ЧУДО_РЫБОНЬКА

Александр Пушкин - "Евгений Онегин"  
Борис Пастернак - "Доктор Живаго"  
Виктор Гюго - "Собор Парижской Богоматери"  
Габриэль Гарсиа Маркес - "Сто лет одиночества"   
Джордж Оруэл - "1984" 
Евгений Замятин - "Мы"  
Жорж Сименон - "Маленький полицейский"  
Зинаида Гиппиус - "Сердце"  
Иван Тургенев - "Отцы и дети"    

й-т ЧУДО_ЕГОРОНЬКа

Йозеф Рот - "Побежденные"  
Кафка Франц - "Превращение"  
Лев Толстой - "Война и мир"  
Маргарет Этвуд - "Служанка"  
Николай Гоголь - "Мертвые души"  
Оскар Уайльд - "Портрет Дориана Грея"  
Патрик Зюскинд - "Парфюмер"  
Рэй Брэдбери - "451 градус по Фаренгейту"  
Стивен Кинг - "Сияние"  
Томас Манн - "Будденброки"  

у-я СРАЗУ

Уильям Фолкнер - "Шум и ярость" 
Фридрих Ницше - "Воля к власти" 
Харуки Мураками - "Норвежский лес"  
Цветаева Marina - "Поэма конца"  
Чак Паланик - "Бойцовский клуб"  
Шарлотта Бронте - "Джейн Эйр"  
Щербаков Валерий - "Сказка о потерянном времени"  
Эрих Мария Ремарк - "На Западном фронте без перемен" 
Юрий Дружков - "Сказки старого волшебника"  
Януш Вишневский - "Одиночество в Сети"  
